. . . . . . . . # . . . . . . . . . . . . . . . .
. . . . . . . . # . . . . . . . . . . . . . . . .
. . . . . . . . # . . . . . . . . . . . . . . . .
. . . . . . . . # . . . . . . . . . . . . . . . .
. . . . . . . . # . . . . . . . . . . . . . . . .
. . . . . . . . # . . . . . . . . . . . . . . . .
. . . . . . . . . . . . . . . . . . . . . . . . .
. . . . . . . . . . . . . . . . . . . . . . . . .
. . . . . . . . . . . . . . . . . . . . . . . . .
. . . . . . . . # . . . . . . . . . . . . . . . .
. . . . . . . . # . . . . . . . . . . . . . . . .
# # # # # # # # # # # # # # # # # # # # # # # # #
. . . . . . . . # . . . . . . . . . . . . . . . .
. . . . . . . . # . . . . . . . . . . . . . . . .
. . . . . . . . # . . . . . . . . . . . . . . . .
. . . . . . . . . . . . . . . . . . . . . . . . .
. . . . . . . . . . . . . . . . . . . . . . . . .
. . . . . . . . . . . . . . . . . . . . . . . . .
. . . . . . . . # . . . . . . . . . . . . . . . .
. . . . . . . . # . . . . . . . . . . . . . . . .
