. . . . . . . . . # . . . . . . . . . . . . . . .
. . . . . . . . . # . . . . . . . . . . . . . . .
. . . . . . . . . # . . . . . . . . . . . . . . .
. . . . . . . . . # . . . . . . . . . . . . . . .
. . . . . . . . . # . . . . . . . . . . . . . . .
. . . . . . . . . # . . . . . . . . . . . . . . .
# # # # # # # # # # # # # # # # . . . # # # # # #
. . . . . . . . . . . . . . . . . . . . . . . . .
. . . . . . . . . . . . . . . . . . . . . . . . .
. . . . . . . . . . . . . . . . . . . . . . . . .
. . . . . . . . . . . . . . . . . . . . . . . . .
. . . . . . . . . . . . . . . . . . . . . . . . .
. . . . . . . . . . . . . . . . . . . . . . . . .
# # # # . . . # # # # # # # # # # # # # # # # # #
. . . . . . . . . # . . . . . . . . . . . . . . .
. . . . . . . . . # . . . . . . . . . . . . . . .
. . . . . . . . . # . . . . . . . . . . . . . . .
. . . . . . . . . # . . . . . . . . . . . . . . .
. . . . . . . . . # . . . . . . . . . . . . . . .
. . . . . . . . . # . . . . . . . . . . . . . . .