# # # # # # # # # . . . . . . . # # # # # # # # #
# . . . . . . . . . . . . . . . . . . . . . . . #
# . . . . . . . . . . . . . . . . . . . . . . . #
# . . . . . . . . . . . . . . . . . . . . . . . #
# . . . . . . . . . . . . . . . . . . . . . . . #
# . . . . . . . . . . . . . . . . . . . . . . . #
# . . . . . . . . . . . . . . . . . . . . . . . #
. . . . . . . # # # # # # # # # # # . . . . . . .
. . . . . . . . . . . . . . . . . . . . . . . . .
. . . . . . . . . . . . . . . . . . . . . . . . .
. . . . . . . . . . . . . . . . . . . . . . . . .
. . . . . . . . . . . . . . . . . . . . . . . . .
. . . . . . . # # # # # # # # # # # . . . . . . .
# . . . . . . . . . . . . . . . . . . . . . . . #
# . . . . . . . . . . . . . . . . . . . . . . . #
# . . . . . . . . . . . . . . . . . . . . . . . #
# . . . . . . . . . . . . . . . . . . . . . . . #
# . . . . . . . . . . . . . . . . . . . . . . . #
# . . . . . . . . . . . . . . . . . . . . . . . #
# # # # # # # # # . . . . . . . # # # # # # # # #








